+__++++++__+++______+++__++++_+++_++++_+
|++\++++/++|+|+++___|+|++\++|+|+|+|++|+|
|+++\++/+++|+|+|____++|+++\+|+|+|+|++|+|
|++++\/++++|+|++____|+|+|\+\|+|+|+|++|+|
|+|\++++/|+|+|+|____++|+|+\+++|+|+|__|+|
|_|+\__/+|_|+|______|+|_|++\__|+|______|

+_____++++++++++++++++++++++++++++_____+
|++_++|++++___+++++_++++_+++++___|_+___|
|+|_|+|+++/+++\+++|+|++|+|+++|+++__||__+
|+++__|++/+/_\+\++|+|++|+|+++|++||+++__|
|++|++++/+_____+\+|+|__|+|+__|++||++|__+
|__|+++/_/+++++\_\|______||_____||_____|

+____++++++++++++++++++___++++++++++++++
|++__|++++++_____+++++/+++\++++++____+++
|+|_+++____|+++++|_++/+/_\+\++++|+++_|++
|++_|+|+++_|+++__|_|/+__+_\_\_++|++|_+++
|+|___|++|_|++|__+_/_/__|++_++|_|+++_|_+
|_____|++|_|+++++|______|+|_|+|_|++|___|
+|_______|+|_____|++++++|+++__|+|____|++
++++++++++++++++++++++++|++|++++++++++++
++++++++++++++++++++++++|__|++++++++++++