+__++++++__+++______+++__++++_+++_++++_+
|++\++++/++|+|+++___|+|++\++|+|+|+|++|+|
|+++\++/+++|+|+|____++|+++\+|+|+|+|++|+|
|++++\/++++|+|++____|+|+|\+\|+|+|+|++|+|
|+|\++++/|+|+|+|____++|+|+\+++|+|+|__|+|
|_|+\__/+|_|+|______|+|_|++\__|+|______|