+__++++++__+++______+++__++++_+++_++++_+
|++\++++/++|+|+++___|+|++\++|+|+|+|++|+|
|+++\++/+++|+|+|____++|+++\+|+|+|+|++|+|
|++++\/++++|+|++____|+|+|\+\|+|+|+|++|+|
|+|\++++/|+|+|+|____++|+|+\+++|+|+|__|+|
|_|+\__/+|_|+|______|+|_|++\__|+|______|

+_____++++++++++++++++++++++++++++_____+
|++_++|++++___+++++_++++_+++++___|_+___|
|+|_|+|+++/+++\+++|+|++|+|+++|+++__||__+
|++___|++/+/_\+\++|+|++|+|+++|++||+++__|
|++|++++/+_____+\+|+|__|+|+__|++||++|__+
|__|+++/_/+++++\_\|______||_____||_____|