map_size:x=40,y=19
++++++++++++++++++++++++++++++++++++++++
+__++++++__+++______+++__++++_+++_++++_+
|++\++++/++|+|+++___|+|++\++|+|+|+|++|+|
|+++\++/+++|+|+|____++|+++\+|+|+|+|++|+|
|++++\/++++|+|++____|+|+|\+\|+|+|+|++|+|
|+|\++++/|+|+|+|____++|+|+\+++|+|+|__|+|
|_|+\__/+|_|+|______|+|_|++\__|+|______|
++++++++++++++++++++++++++++++++++++++++
++++++++++++++++++++++++++++++++++++++++
++++++++++++++++++++++++++++++++++++++++
++++++++++++++++++++++++++++++++++++++++
++++++++++++++++++++++++++++++++++++++++
++++++++++++++++++PLAY++++++++++++++++++
++++++++++++++++HIGHSCORE+++++++++++++++
++++++++++++++++++EXIT++++++++++++++++++
++++++++++++++++++++++++++++++++++++++++
++++++++++++++++++++++++++++++++++++++++
++++++++++++++++++++++++++++++++++++++++
++++++++++++++++++++++++++++++++++++++++

