map_size:x=50,y=30

XXXXXXXXXXXXXXXXXXXXXXXXXXXXXXXXXXXXXXXXXXXXXXXXXX
+++++++++NNNNNN+++++++++++++++++++++++++++++++++++
+++++++++NXXXXX++++++++++++++++++++++++++++++++N++
+++++++++NX+++++++++++++++++++++++++++++++++++N+++
+++++++++NX++++++++++++++N++++++++++++++++++++++++
+++++++++NX+++++++++++NNNN++++++++++++++++++++++++
++++++++++++++++++++++++++++++++++++++++++++++++++
+++++++++++++N++++++++++++++++++++++++++++++++++++
+++++++++NNNNN+++++++++++++++XXXXXXXXXXXXXXXXXXXXX
+++++++++++++N++++++++++++++++++++++++++++++++++++
++++++++++++++++++++++++++++++++++++++++++++++++++
XXXXXXXXXXXXX+++++++++++++++++++++++++++++++++++++
+++++++++++++N++++++++++++++++++++++++++++++++++++
+++++++++++++N++++++++++++++++++++++++++++++++++++
+++++++++++++N++++++++++++++++++++++++++++++++++++
+++++++++++++NNNNN++++++++++++++++++++++++++++++++
+++++++++++++N++++++++++++++++++++++++++++++++++++
+++++++++++++N++++++++++++++++++++++++++++++++++++
+++++++++++++N++++++++++++++++++++++++++++++++++++
+++++++++++++N++++++++++++++++++++++++++++++++++++
N++++++++++++N++++++++++++++++++++++++++++++++++++
N+++++++++++++++++++++++++++++++++++++++++++++++++
N++++++++++++++++++++++++++++++NNNNN++++++++++++++
N++++++++++++++++XXXXXXXXXXXXXXXXXXN++++++++++++++
N++++++++++++++++++++++++++++++++NNN++++++++++++++
N+++++++++++++++++++++++++++++++++++++++++++++++++
NNNNN+++++++++++++++++++++++++++++++++++++++++++++
XXXXXXXXXXXXXXXXXXXXXXXXXXXXXXXXXXXX++++++++++++++
++++++++++++++++++++++++++++++++++++++++++++++++++
