map_size:x=40,y=19
++++++++++++++++++++++++++++++++++++++++
+____++++++++++++++++++___++++++++++++++
|++__|++++++_____+++++/+++\++++++____+++
|+|_+++____|+++++|_++/+/_\+\++++|+++_|++
|++_|+|+++_|+++__|_|/+__+_\_\_++|++|_+++
|+|___|++|_|++|__+_/_/__|++_++|_|+++_|_+
|_____|++|_|+++++|______|+|_|+|_|++|___|
+|_______|+|_____|++++++|+++__|+|____|++
++++++++++++++++++++++++|++|++++++++++++
++++++++++++++++++++++++|__|++++++++++++
++++++++++++++++++++++++++++++++++++++++
++++++++++++++++++++++++++++++++++++++++
++++++++++++++++++++++++++++++++++++++++
++++++++++++++++++PLAY++++++++++++++++++
++++++++++++++++HIGHSCORE+++++++++++++++
++++++++++++++++++EXIT++++++++++++++++++
++++++++++++++++++++++++++++++++++++++++
++++++++++++++++++++++++++++++++++++++++
++++++++++++++++++++++++++++++++++++++++

