map_size:x=40,y=19
++++++++++++++++++++++++++++++++++++++++
+_____++++++++++++++++++++++++++++_____+
|++_++|++++___+++++_++++_+++++___|_+___|
|+|_|+|+++/+++\+++|+|++|+|+++|+++__||__+
|++___|++/+/_\+\++|+|++|+|+++|++||+++__|
|++|++++/+_____+\+|+|__|+|+__|++||++|__+
|__|+++/_/+++++\_\|______||_____||_____|
++++++++++++++++++++++++++++++++++++++++
++++++++++++++++++++++++++++++++++++++++
++++++++++++++++++++++++++++++++++++++++
++++++++++++++++++++++++++++++++++++++++
+++++++++++++++MAIN+MENU++++++++++++++++
+++++++++++++++++RESUME+++++++++++++++++
++++++++++++++++++EXIT++++++++++++++++++
++++++++++++++++++++++++++++++++++++++++
++++++++++++++++++++++++++++++++++++++++
++++++++++++++++++++++++++++++++++++++++
++++++++++++++++++++++++++++++++++++++++
++++++++++++++++++++++++++++++++++++++++